奥巴马周二在白宫会晤日本首相安倍晋三 	博讯网
安倍访洛杉矶 三百民众示威迎接 	博讯网
 美国敦促日本解决诱拐美国儿童问题	美国之音
 安倍访加州谈科技 场外抗议声浪高	美国之音
 安倍将访旧金山 亚裔示威要求道歉 	美国之音
日相安倍晋三抵达访美之行第一站 - BBC Chinese	BBC中文网
日相安倍晋三抵达访美之行第一站 - BBC Chinese	BBC中文网
       安倍对美国进行里程碑式访问 以展示两国密切关系| Reuters	路透社网
       港报社评：两岸关系将会继续模糊--信报5月4日| Reuters	路透社网
       24小时时事新闻（4月28日）| Reuters	路透社网
       日本首相安倍不会参加俄罗斯二战纪念活动--内阁官房长官| Reuters	路透社网
       路透4月照片精选（下）| Reuters	路透社网
安倍回应慰安妇问题 未明确道歉 - 快讯-文汇网	香港文汇报
中国转变对美国亚太自贸协定看法 - 纽约时报中文网 国际纵览	纽约时报中文网
奥巴马将在白宫正式欢迎日本首相到访	《参与》
安倍访洛杉矶 三百民众示威迎接	《参与》
安倍访美对华表态强硬 中方撂三句话警告美日 - 军事动态 - 倍可亲	倍可亲网
奥巴马周二在白宫会晤日本首相安倍晋三 	博讯网
安倍访洛杉矶 三百民众示威迎接 	博讯网
安倍到访旧金山 华人贴身抗议	自由亚洲电台
安倍向二战纪念碑献花圈 期望缓解外界批评	自由亚洲电台
安倍启程访美 将赴国会发表历史演说 图 - 阿波罗新闻网	阿波罗新闻网
美国与日本 共同保卫钓鱼岛 图 - 阿波罗新闻网	阿波罗新闻网
中国评论新闻：南加州华裔韩裔抗议安倍访美　成功围堵车队	中评社
中国评论新闻：赖清德：美日紧密结盟有助亚太和平稳定	中评社
 安倍访美 推销新日本观及平息争议 | 国际焦点 | 中央社即时新闻 CNA NEWS	台湾中央社
 安倍心痛慰安妇 遭批规避道歉 | 国际焦点 | 中央社即时新闻 CNA NEWS	台湾中央社
 传日考虑加入美国 共同巡逻南海 | 国际焦点 | 中央社即时新闻 CNA NEWS	台湾中央社
 【安倍访美】菜式具深意 国宴Fusion菜招呼安倍 | 即时新闻 | 国际 | 20150428	香港苹果日报
