中国长江船难数百人失踪 	博讯网
 中国一艘客轮在长江倾覆 多人下落不明	美国之音
 中国长江船难数百人失踪	美国之音
 中国长江船难家属不满当局应急工作	美国之音
 中国抓紧寻找沉船事故幸存者	美国之音
 中国救援人员继续寻找翻沉客轮幸存者	美国之音
 何清涟：独裁者重组暴政俱乐部 - 写于六四26周年前夕	美国之音
??陆?差唉纯???拜???-地焊刁ら厨	华尔街日报
媒体揭秘李克强的应急救援班底_大陆_新闻_星岛环球网	星岛环球网
专家:长江翻沉客轮船长很难被认定失职_突发新闻_社会_星岛环球网	星岛环球网
东方之星沉船已有15人获救 - 快讯-文汇网	香港文汇报
民间救助队严守下游 盼东方之星创造奇迹 - 快讯-文汇网	香港文汇报
湖南七四煤矿事故致8人死亡 - 快讯-文汇网	香港文汇报
中国长江船难数百人失踪 	博讯网
到底是什么 导致“东方之星”翻沉惨剧 	博讯网
中国抓紧寻找沉船事故幸存者 	博讯网
长江倾覆客轮里仍有人活着 已打捞上来一具遗体 	博讯网
“东方之星”客轮长江倾覆 广大佛子祈愿平安_佛教频道_大公网	大公网
东方之星客轮翻沉事故已有15人获救_大公资讯_大公网	大公网
456人沉江，李克强的应急救援班底_大公资讯_大公网	大公网
中国客轮长江沉船 四百余人仍失踪	自由亚洲电台
长江沉船救援进展缓慢家属不满  媒体报道受限	自由亚洲电台
长江客轮倾覆 潜水员发现沉船内仍有人活着（图） - 阿波罗新闻网	阿波罗新闻网
长江客轮倾覆 潜水员发现沉船内仍有人活着（图） - 阿波罗新闻网	阿波罗新闻网
任平生：“东方之星”的沉没 - 阿波罗新闻网	阿波罗新闻网
周晓辉：长江沉船原因请别急于下结论 - 阿波罗新闻网	阿波罗新闻网
港媒：船到江心补漏迟 陆港乱象三分天灾七分人祸 - 阿波罗新闻网	阿波罗新闻网
沉痛悲壮 史上八大最致命沉船事故_天下-多维新闻网	多维新闻网
长江客轮倾覆后思考：沉船逃生必备常识_天下-多维新闻网	多维新闻网
天灾亦是人祸？“东方之星”倾覆三大谜团_中国-多维新闻网	多维新闻网
CNN：东方之星幸存者被重兵看守_国际-多维新闻网	多维新闻网
回音壁：穿越沉船封锁线 把脉中南海_国际-多维新闻网	多维新闻网
 【长江沉轮】日教授：东方之星船体过高 或引致倾覆 | 即时新闻 | 两岸 | 20150602	香港苹果日报
 【长江沉轮】印总理莫迪震惊 发微博为遇难者祈福 | 即时新闻 | 两岸 | 20150602	香港苹果日报
 【长江沉轮】东方之星最后影像曝光 | 即时新闻 | 两岸 | 20150602	香港苹果日报
 载458人豪华客轮 遇龙卷风长江沉没 | 即时新闻 | 两岸 | 20150602	香港苹果日报
客轮长江翻沉至少7死 435人今晨仍困船舱 | 苹果日报 | 要闻港闻 | 20150603	香港苹果日报
 【长江沉轮】同公司同型号 「东方之珠」要停航检查 | 即时新闻 | 两岸 | 20150603	香港苹果日报
 【湖北直击】医院收治5伤者 不准记者采访 | 即时新闻 | 两岸 | 20150602	香港苹果日报
 【长江沉轮】一路无眠抵湖北 家属被指引去殡仪馆 | 即时新闻 | 两岸 | 20150603	香港苹果日报
